5 4 4 4 4 4 4 4 4 4 4 4 4 4 4 4 4 1 0 2 4 4 4 4 4 4 4 4 4 4 4 4 1 0 2 4 4 4 1 0 2 4 4 4 4 4 4 4 4 4 4 5
5 1 0 2 4 4 4 4 4 4 4 4 4 4 4 4 4 4 4 4 4 4 4 4 4 4 1 0 2 4 4 1 0 2 4 4 4 4 4 4 4 4 4 4 1 0 2 4 4 4 4 5
5 4 4 4 4 4 4 4 4 4 4 4 4 4 4 4 4 4 4 4 4 4 4 4 4 4 4 4 4 4 4 4 4 1 0 2 1 0 2 4 4 4 4 1 0 2 4 4 4 4 4 5
5 4 4 4 4 4 4 4 4 4 4 4 4 4 4 4 4 4 4 4 4 4 4 4 1 0 2 4 4 4 1 0 2 4 4 4 4 4 4 4 4 4 1 0 2 4 4 4 4 4 4 5
5 4 4 4 4 4 4 4 4 4 4 4 4 4 1 0 2 4 4 4 4 4 4 4 4 4 4 4 4 4 4 4 4 4 4 1 0 2 4 4 4 4 4 4 4 4 4 4 4 4 4 5
5 4 4 4 4 4 4 4 4 4 4 4 4 4 4 4 4 4 4 4 4 4 4 4 4 4 4 4 4 4 4 4 4 4 4 4 4 4 4 4 4 4 4 4 4 4 4 4 4 4 4 5
5 4 4 4 4 4 4 4 4 4 4 4 4 4 4 4 4 4 4 1 0 2 4 1 0 2 4 4 4 4 4 4 1 0 2 4 4 4 4 1 0 2 4 4 4 4 4 4 4 4 4 5
5 4 4 4 4 4 4 4 4 4 4 4 4 4 4 4 4 4 4 4 4 4 4 4 4 4 4 4 4 4 4 4 4 4 4 4 4 4 4 1 0 2 4 4 4 4 4 4 4 4 4 5
5 4 4 4 4 4 4 4 4 4 4 4 4 4 4 4 4 4 4 4 4 4 4 4 4 4 4 4 4 4 4 4 4 1 0 2 4 4 4 4 4 4 4 4 4 4 4 4 4 4 4 5
5 4 4 4 4 4 4 4 4 1 0 2 4 4 4 4 4 4 4 4 4 4 4 4 4 4 1 0 2 4 4 4 4 4 4 4 4 4 4 4 4 4 4 4 4 4 4 1 0 2 4 5
5 4 4 4 4 4 4 4 4 4 4 1 0 2 4 4 4 4 4 4 4 4 1 0 2 4 4 4 4 4 4 1 0 2 4 4 4 4 4 4 4 1 0 2 4 4 4 1 0 2 4 5
5 4 4 4 4 4 4 4 4 4 4 4 4 4 4 4 4 4 4 4 1 0 2 4 4 4 1 0 2 4 4 4 4 4 4 4 4 4 4 4 4 4 4 4 4 4 4 4 4 4 4 5
5 4 4 4 4 4 4 4 4 4 4 4 4 4 4 4 1 0 2 4 4 4 4 4 4 4 4 4 4 4 4 4 4 4 4 4 4 4 4 4 4 4 4 4 4 4 4 4 4 4 4 5
5 4 4 4 4 4 4 4 4 4 4 4 4 4 4 4 4 4 4 4 4 4 4 4 1 0 2 4 1 0 2 4 4 4 4 4 4 4 4 4 4 4 4 4 1 0 2 4 4 4 4 5
5 4 4 4 4 1 0 2 4 4 4 4 4 4 4 4 1 0 2 4 4 4 4 4 4 4 4 4 4 4 4 4 4 1 0 2 4 4 4 4 4 4 4 4 4 4 4 4 4 4 4 5
5 4 4 4 4 4 4 4 4 4 4 4 4 4 4 4 4 4 4 4 4 4 4 4 4 4 4 4 4 4 4 4 4 4 4 4 4 4 4 4 4 4 1 0 2 4 4 4 4 4 4 5
5 4 4 4 4 4 4 4 4 4 4 4 4 1 0 2 4 4 4 4 4 4 4 4 4 4 4 4 4 4 4 4 4 4 4 4 4 4 4 4 4 4 4 4 4 4 4 4 4 4 4 5
5 4 4 4 4 4 4 4 4 4 4 4 1 0 2 4 4 4 4 4 4 4 4 4 4 4 4 4 4 4 4 4 4 4 4 1 0 2 4 4 4 4 4 4 4 4 4 4 4 4 4 5
5 4 4 4 4 4 4 4 4 4 4 4 4 4 4 4 4 4 4 4 4 4 4 4 4 4 4 4 4 4 4 4 4 1 0 2 4 4 4 4 4 4 4 1 0 2 4 4 4 4 4 5
5 4 4 4 4 4 4 4 4 4 4 4 4 4 4 4 4 4 4 1 0 2 4 4 4 4 4 4 4 4 4 4 4 4 4 4 4 4 4 4 4 4 4 4 4 4 4 4 4 4 4 5
5 4 4 4 4 4 4 4 4 4 4 1 0 2 1 0 2 1 0 2 4 4 4 4 4 4 4 4 4 1 0 2 4 4 4 4 4 4 4 4 4 4 1 0 2 4 4 4 4 4 4 5
5 4 4 4 4 4 4 4 4 4 4 4 4 4 4 4 4 4 4 4 4 4 4 4 4 4 4 4 4 4 4 4 4 4 4 4 4 4 1 0 2 4 4 4 4 4 4 4 4 4 4 5
5 4 4 4 4 4 4 4 4 1 0 2 4 4 4 1 0 2 4 4 4 4 4 4 4 4 4 4 4 4 4 4 4 4 4 4 4 4 4 1 0 2 4 4 4 4 4 4 4 4 4 5
5 4 4 4 4 4 4 4 4 4 4 4 4 4 4 4 4 4 4 4 4 1 0 2 4 4 1 0 2 4 4 4 4 4 4 4 4 4 4 4 1 0 2 4 4 4 4 1 0 2 4 5
5 4 1 0 2 4 4 4 4 4 4 4 4 4 4 4 4 4 4 4 4 4 4 1 0 2 4 4 4 4 4 4 4 4 4 4 4 4 4 4 4 1 0 2 4 1 0 2 4 4 4 5
5 4 4 4 4 4 4 4 4 4 4 4 4 4 4 4 4 4 4 4 4 4 4 4 4 4 4 4 4 4 4 4 4 4 4 4 4 4 4 4 4 4 4 4 4 4 4 4 4 4 4 5
5 4 4 4 4 4 4 4 4 4 4 4 4 4 4 4 1 0 2 1 0 2 1 0 2 4 4 4 4 4 4 4 4 4 4 4 4 4 4 4 4 4 4 4 4 4 4 1 0 2 4 5
5 4 4 4 4 4 1 0 2 4 4 4 4 4 4 4 4 4 4 1 0 2 4 4 4 4 4 4 4 4 4 4 4 4 4 4 4 4 4 4 4 4 4 4 4 4 4 4 4 4 4 5
5 4 4 4 4 4 4 4 4 4 4 4 4 4 4 4 4 4 4 4 4 4 4 4 4 4 1 0 2 4 4 4 4 4 4 4 4 4 4 1 0 2 4 4 4 4 4 4 4 4 4 5
5 4 4 4 4 4 4 4 4 4 1 0 2 4 4 4 4 4 4 4 4 4 4 4 4 4 4 4 4 4 4 4 4 4 4 4 4 4 4 4 4 4 4 4 1 0 2 4 4 4 4 5
5 4 4 4 4 4 4 4 4 4 1 0 2 4 4 4 4 4 4 4 4 4 4 4 4 4 4 1 0 2 4 4 4 4 4 4 4 4 4 1 0 2 4 4 4 4 4 4 4 4 4 5
5 4 4 4 4 4 4 4 1 0 2 4 4 4 4 4 4 4 4 4 4 4 4 4 4 4 4 4 1 0 2 4 4 4 4 4 4 4 4 4 1 0 2 4 4 4 4 4 4 4 4 5
5 4 4 4 4 4 4 4 4 4 4 4 4 4 4 4 4 4 4 4 4 4 4 4 4 4 4 4 1 0 2 4 4 4 4 4 4 4 4 1 0 2 4 4 4 4 4 4 4 4 4 5
5 4 4 1 0 2 4 4 4 4 4 4 4 4 4 4 4 4 4 4 4 4 4 4 4 4 4 4 4 4 4 4 4 4 4 4 4 4 4 4 4 4 4 4 4 4 4 4 4 4 4 5
5 4 4 4 4 4 4 4 4 4 4 4 4 4 4 4 4 1 0 2 4 4 4 4 1 0 2 4 4 4 4 4 4 4 4 4 4 4 4 4 4 4 4 4 4 4 4 4 4 4 4 5
5 4 4 1 0 2 4 4 4 1 0 2 4 4 4 4 4 1 0 2 4 4 4 4 4 4 1 0 2 4 4 4 4 4 4 4 4 4 4 4 4 4 4 4 4 4 4 4 4 4 4 5
5 4 4 4 4 4 4 4 4 4 4 4 4 4 4 4 4 4 4 4 4 4 1 0 2 4 4 4 4 4 4 4 4 4 4 4 4 4 4 4 4 4 4 4 4 1 0 2 4 4 4 5
5 4 4 4 4 4 4 1 0 2 4 4 4 4 4 4 4 4 4 4 4 4 4 4 4 4 4 4 4 4 4 4 4 4 4 4 4 4 4 4 4 4 4 4 4 4 4 4 4 4 4 5
5 4 4 4 4 4 4 4 4 1 0 2 4 4 4 4 4 4 4 4 4 4 4 4 4 4 4 4 4 4 4 4 4 4 4 4 4 4 4 4 4 4 4 4 4 4 4 4 4 4 4 5
5 4 4 4 4 4 4 4 4 4 4 4 4 4 4 4 4 4 4 4 4 4 4 4 1 0 2 4 4 4 4 4 4 4 4 4 4 4 4 4 4 4 4 4 4 1 0 2 4 4 4 5
5 4 4 4 4 4 4 1 0 2 4 4 4 4 4 4 4 4 4 4 4 1 0 2 4 4 4 4 4 4 4 4 4 4 4 4 4 4 4 4 4 4 4 4 4 4 4 4 4 4 4 5
5 4 4 1 0 2 4 4 4 4 4 4 4 4 4 4 4 4 4 4 4 4 4 1 0 2 4 4 4 4 4 4 4 4 4 4 4 4 4 4 4 4 4 4 4 4 4 4 4 4 4 5
5 4 4 4 4 4 4 4 4 4 4 4 4 4 4 1 0 2 4 4 4 4 4 4 4 4 4 4 4 4 4 4 4 4 4 4 4 4 4 4 4 4 4 4 4 4 4 4 4 4 4 5
5 4 4 4 4 4 4 4 4 4 4 4 4 4 4 4 4 4 1 0 2 4 4 4 4 4 4 4 4 4 4 4 4 4 4 4 4 4 4 4 4 4 4 4 4 4 4 4 4 4 4 5
5 4 4 4 4 4 4 4 4 4 4 4 4 4 4 4 4 4 4 4 4 4 4 4 1 0 2 4 4 4 4 4 4 4 4 4 4 4 4 4 4 4 4 4 4 4 4 1 0 2 4 5
5 4 4 4 4 4 4 4 4 4 4 4 4 4 4 4 4 4 4 4 4 4 4 4 4 4 4 4 4 4 4 4 4 4 1 0 2 4 4 4 4 4 4 4 4 4 4 4 4 4 4 5
5 4 4 4 4 4 4 4 4 4 4 4 4 4 4 4 4 1 0 2 4 4 4 4 4 4 4 4 4 4 4 4 4 4 4 4 4 4 4 4 1 0 2 4 4 4 4 4 4 4 4 5
5 4 1 0 2 1 0 2 4 4 4 4 4 4 4 4 4 4 4 4 4 4 1 0 2 4 4 4 4 4 4 4 4 4 4 4 4 4 4 4 4 4 4 4 4 4 4 4 4 4 4 5
5 4 4 4 4 4 4 4 4 4 4 4 4 4 4 4 4 4 4 4 4 4 4 4 4 4 4 4 4 4 4 4 4 4 4 4 4 4 4 4 4 4 4 4 4 4 4 4 4 4 4 5
5 4 4 4 4 4 1 0 2 4 4 4 1 0 2 4 4 4 4 4 4 4 4 4 4 4 4 4 4 4 4 4 4 4 4 4 4 4 4 4 4 4 4 4 4 1 0 2 4 4 4 5
5 4 4 4 4 4 4 4 4 1 0 2 4 4 4 4 4 4 1 0 2 4 4 4 4 4 4 4 4 4 4 4 4 4 4 4 4 4 4 4 4 4 4 4 4 4 4 4 4 4 4 5
5 4 4 1 0 2 4 4 4 4 4 1 0 2 4 4 4 4 4 4 4 4 4 4 4 4 4 4 4 4 4 4 4 4 4 4 4 4 4 4 4 4 4 4 4 4 4 4 4 4 4 5
5 4 4 4 4 4 4 4 4 4 4 4 4 4 4 4 4 4 4 4 4 4 4 4 4 4 4 4 4 4 4 4 4 4 4 4 4 4 4 4 4 4 4 4 4 4 4 4 4 4 4 5
5 4 4 4 4 4 4 4 4 4 4 4 4 4 4 4 4 4 4 4 4 4 4 4 4 4 4 4 4 4 4 4 4 4 4 4 4 4 4 1 0 2 4 4 4 4 4 4 4 4 4 5
5 4 4 4 4 4 4 4 4 4 4 4 4 4 1 0 2 4 1 0 2 4 4 4 4 4 4 4 4 4 4 4 4 4 4 4 4 4 4 4 4 4 4 4 4 4 4 4 4 4 4 5
5 4 4 4 4 4 4 4 4 4 4 4 4 4 1 0 2 4 4 4 4 4 4 4 4 4 4 4 4 4 4 4 4 4 4 1 0 2 4 4 4 4 4 1 0 2 1 0 2 4 4 5
5 4 4 4 4 4 4 4 4 4 4 1 0 2 1 0 2 4 4 4 4 4 4 4 4 4 1 0 2 4 4 4 4 4 4 4 4 4 4 4 4 4 1 0 2 4 4 4 4 4 4 5
5 4 4 4 4 4 4 4 4 4 4 4 4 4 4 4 4 4 1 0 2 4 4 4 4 4 4 4 4 4 4 4 4 4 4 4 4 4 4 4 4 4 4 4 4 4 4 4 4 4 4 5
5 4 4 4 1 0 2 4 4 4 4 4 4 4 4 4 4 4 4 4 4 4 4 4 4 4 4 4 4 4 4 4 4 4 4 4 1 0 2 4 4 4 1 0 2 4 4 4 4 4 4 5
5 4 4 4 4 4 4 4 4 1 0 2 4 1 0 2 4 4 4 4 4 4 4 4 4 4 4 4 4 4 4 4 4 4 4 4 4 4 4 4 4 1 0 2 4 4 4 4 4 4 4 5
5 4 4 4 4 4 4 4 4 4 4 4 4 4 4 4 1 0 2 4 4 4 4 4 4 4 4 4 4 4 4 4 4 4 4 4 4 4 4 4 4 4 4 4 4 4 4 4 4 4 4 5
5 4 4 4 1 0 2 4 4 4 4 4 4 4 4 1 0 2 4 4 4 4 4 4 4 4 4 4 4 4 4 4 4 4 4 4 4 4 4 4 4 4 4 4 4 4 4 4 4 4 4 5
5 4 4 4 4 4 4 4 4 4 4 4 4 4 4 4 4 4 4 4 4 4 4 4 4 4 4 4 4 4 4 4 4 4 4 4 4 4 4 4 4 1 0 2 4 4 4 4 4 4 4 5
5 4 4 4 4 4 4 4 4 4 4 4 4 4 4 4 4 4 4 4 4 4 4 4 4 4 4 4 4 4 4 4 4 4 4 4 1 0 2 4 4 4 4 4 4 4 4 4 4 4 4 5
5 4 4 4 4 4 4 4 4 1 0 2 4 4 4 4 4 1 0 2 4 4 4 4 4 4 4 4 4 4 4 4 4 4 4 4 4 4 4 4 4 4 4 4 4 1 0 2 4 4 4 5
5 4 4 4 4 4 4 4 4 4 4 4 4 4 4 4 4 4 4 4 4 4 4 4 4 4 4 4 4 4 4 4 4 4 4 4 1 0 2 4 4 4 4 4 4 4 4 4 4 4 4 5
5 4 4 4 4 1 0 2 4 4 4 4 4 4 4 4 1 0 2 4 4 4 4 4 4 4 4 4 4 4 4 4 4 4 4 4 4 4 4 4 4 4 4 4 4 4 4 4 4 4 4 5
5 4 4 4 4 4 4 4 4 4 4 4 1 0 2 4 4 4 4 4 4 1 0 2 4 4 4 4 4 4 4 4 4 4 4 1 0 2 4 4 4 4 4 4 4 4 4 4 4 4 4 5
5 4 4 4 4 4 4 4 4 4 4 4 4 4 4 4 1 0 2 4 4 4 4 4 4 4 4 1 0 2 4 4 4 4 4 4 4 4 4 4 4 4 4 4 4 4 4 4 4 4 4 5
5 4 4 4 4 4 4 4 4 4 4 4 4 4 4 4 4 4 4 4 4 4 4 4 4 4 1 0 2 4 4 4 4 4 4 4 4 4 1 0 2 4 4 4 4 4 4 4 4 4 4 5
5 4 4 4 4 4 1 0 2 4 4 4 4 1 0 2 4 4 4 4 4 4 4 4 1 0 2 4 4 4 4 4 4 1 0 2 4 4 4 4 4 4 4 4 4 4 4 4 4 4 4 5
5 4 1 0 2 4 4 4 4 4 4 4 4 4 4 4 4 4 4 4 4 4 4 4 4 4 4 4 4 4 4 4 4 4 4 4 4 4 4 4 4 4 4 4 4 4 4 4 4 4 4 5
5 4 4 4 4 4 4 4 4 4 4 4 4 4 4 4 4 4 4 4 4 4 4 4 4 4 4 4 4 4 1 0 2 4 4 1 0 2 4 4 4 4 4 4 4 4 4 4 4 4 4 5
5 4 4 4 4 4 1 0 2 4 4 4 4 4 4 4 4 4 4 4 4 4 4 4 1 0 2 1 0 2 1 0 2 4 4 4 4 4 4 4 4 4 4 1 0 2 4 4 4 4 4 5
5 4 4 4 4 4 4 4 4 4 4 4 4 4 4 4 4 4 4 4 4 4 4 4 4 4 4 4 4 4 4 4 4 4 4 4 4 4 1 0 2 4 4 4 4 4 4 4 4 4 4 5
5 4 4 4 4 4 4 4 4 4 4 4 4 4 4 4 4 4 4 4 4 4 4 4 4 4 4 4 4 4 4 1 0 2 4 4 4 4 4 4 4 4 4 4 4 4 4 4 4 4 4 5
5 4 4 4 4 4 4 4 4 4 1 0 2 4 4 4 4 4 4 4 4 4 4 4 4 4 4 4 4 4 4 4 4 4 4 4 4 4 4 4 4 1 0 2 4 4 4 4 4 4 4 5
5 4 4 4 4 4 4 4 4 4 4 4 4 4 4 4 1 0 2 4 4 4 4 4 4 4 4 4 4 4 4 4 4 4 4 4 4 4 4 4 4 4 4 4 4 4 4 4 4 4 4 5
5 4 4 4 4 4 4 4 4 4 4 4 4 4 4 4 1 0 2 4 1 0 2 4 4 4 4 4 4 4 4 4 4 4 4 4 4 4 4 4 4 4 4 4 4 4 4 4 4 4 4 5
5 4 4 4 4 4 1 0 2 4 4 4 4 4 4 1 0 2 4 4 4 4 4 4 4 4 4 4 4 4 4 4 1 0 2 4 4 4 4 4 4 4 4 4 4 4 4 4 4 4 4 5
5 4 4 4 4 4 4 4 4 4 1 0 2 4 4 4 4 4 4 4 4 4 4 4 4 4 4 4 4 4 4 4 4 4 4 4 4 4 4 4 4 4 4 4 4 4 4 4 4 4 4 5
5 4 4 4 4 4 4 4 4 4 4 4 4 4 4 4 4 4 4 4 4 4 1 0 2 4 4 4 4 4 4 4 4 4 4 1 0 2 4 4 4 4 4 4 4 4 4 4 4 4 4 5
5 4 4 4 1 0 2 4 4 4 4 4 4 4 1 0 2 4 4 4 4 1 0 2 4 4 4 4 4 4 4 4 4 4 4 4 4 4 4 4 4 4 4 4 4 1 0 2 4 4 4 5
5 4 4 4 4 4 4 4 4 4 4 4 4 4 4 4 4 4 4 4 4 4 4 4 4 4 4 4 4 4 4 4 4 4 4 4 4 4 4 4 1 0 2 4 4 4 4 4 4 4 4 5
5 4 4 4 4 1 0 2 4 4 4 4 4 4 4 4 4 4 4 4 4 4 4 4 4 4 4 4 4 4 4 4 4 4 4 4 4 4 4 4 4 4 4 4 4 4 4 4 4 4 4 5
5 4 4 4 4 4 4 4 4 4 4 4 4 4 4 4 4 4 4 4 4 4 4 4 4 4 4 4 4 4 4 4 4 4 4 4 4 4 4 4 4 4 4 4 4 4 4 4 4 4 4 5
5 4 4 4 4 1 0 2 4 4 4 4 4 4 4 4 4 4 4 4 4 4 4 4 4 4 4 4 4 4 4 4 4 4 4 4 4 4 1 0 2 4 4 4 4 4 4 4 4 4 4 5
5 4 4 4 4 4 4 4 4 4 4 4 4 4 4 4 4 1 0 2 4 4 4 4 4 4 4 4 4 4 4 4 4 4 4 4 4 4 4 4 4 4 4 4 4 1 0 2 4 4 4 5
5 4 4 4 4 4 4 4 4 4 4 4 4 4 4 4 4 4 4 4 4 4 4 4 4 4 4 4 4 4 4 4 4 4 1 0 2 4 4 4 4 4 4 4 4 4 4 4 4 4 4 5
5 1 0 2 4 4 4 4 4 4 4 4 4 4 4 4 4 4 4 4 4 4 1 0 2 4 4 4 4 4 4 4 4 4 1 0 2 4 4 1 0 2 4 4 4 4 4 4 4 4 4 5
5 4 1 0 2 4 4 4 4 4 4 4 1 0 2 4 4 4 4 4 4 4 4 4 4 4 4 4 4 4 4 4 4 4 4 4 4 1 0 2 4 4 4 4 4 4 4 4 4 4 4 5
5 4 4 4 4 1 0 2 4 4 4 4 1 0 2 4 4 4 4 4 4 4 4 4 4 4 4 4 4 4 1 0 2 4 4 4 4 4 4 4 1 0 2 4 4 4 4 4 4 4 4 5
5 4 4 4 4 4 4 4 4 4 4 4 1 0 2 4 4 4 4 4 4 4 4 4 4 4 4 4 4 4 4 4 4 4 4 4 4 4 4 4 4 1 0 2 4 4 4 4 4 4 4 5
5 4 4 4 4 4 4 4 4 4 4 4 4 4 4 4 4 4 4 4 4 4 4 4 4 4 4 4 4 4 4 4 4 4 4 4 4 4 4 4 4 4 1 0 2 4 4 4 4 4 4 5
5 4 4 4 4 4 4 4 4 4 4 4 4 4 4 4 4 4 4 4 4 4 4 4 4 4 4 4 4 4 4 4 4 4 4 4 4 4 4 4 4 4 4 4 1 0 2 4 4 4 4 5
5 4 4 4 4 4 4 4 4 4 4 4 1 0 2 4 4 4 1 0 2 1 0 2 4 4 4 4 4 4 4 1 0 2 4 4 4 4 4 4 4 4 4 4 4 1 0 2 4 4 4 5
5 4 4 4 4 4 4 4 4 4 4 4 4 4 4 4 4 4 4 4 4 4 4 4 4 4 4 4 4 4 4 4 4 4 4 4 4 4 1 0 2 4 4 4 4 4 4 1 0 2 4 5
5 4 4 4 4 4 4 4 4 4 4 4 1 0 2 4 4 4 4 4 4 4 4 4 4 4 4 4 4 4 4 4 4 4 4 4 4 4 1 0 2 4 4 4 4 4 4 4 4 4 4 5
5 1 0 2 4 4 4 4 4 4 4 4 4 4 4 4 4 4 4 4 4 4 4 4 4 4 4 4 4 4 4 4 4 4 4 4 4 4 4 4 4 4 4 4 4 4 1 0 2 4 4 5
5 4 4 4 4 4 4 4 4 4 4 4 4 4 4 4 4 4 4 4 4 4 4 4 4 4 4 4 4 4 4 4 4 4 4 4 4 4 1 0 2 4 4 4 4 4 1 0 2 4 4 5
5 4 4 4 4 4 4 4 4 4 4 4 4 4 4 4 4 4 4 4 4 4 4 4 4 4 4 1 0 2 4 4 4 4 4 4 4 4 4 4 4 4 4 4 4 4 4 4 4 4 4 5
5 4 4 4 4 4 4 4 4 4 4 4 4 4 4 4 4 4 4 4 4 4 4 4 4 4 4 4 4 4 4 4 4 4 4 4 4 4 1 0 2 4 4 4 4 4 4 1 0 2 4 5
5 4 4 4 4 4 4 4 4 4 4 4 4 4 4 1 0 2 4 4 4 4 4 4 4 4 4 4 4 4 4 4 4 4 4 4 4 4 4 4 4 4 4 4 4 4 4 4 4 4 4 5
5 4 4 4 4 4 4 4 4 1 0 2 4 4 4 1 0 2 4 4 4 4 4 4 4 4 4 4 4 4 1 0 2 4 4 4 4 4 4 4 4 1 0 2 4 4 4 4 4 4 4 5
5 4 4 4 4 4 4 4 4 4 4 4 1 0 2 4 4 4 4 4 4 4 4 1 0 2 1 0 2 4 4 4 4 4 4 4 4 4 4 4 1 0 2 4 4 4 4 4 4 4 4 5
5 4 4 4 4 4 4 4 4 4 4 4 4 4 4 4 4 4 4 4 4 4 4 4 4 4 4 4 4 4 4 4 4 4 4 4 4 4 4 4 4 4 4 4 4 4 4 4 4 4 4 5
5 4 4 4 4 4 4 4 4 4 4 4 4 4 4 4 4 4 4 4 4 4 4 4 4 4 4 4 4 4 4 4 4 4 4 4 4 4 4 1 0 2 4 4 4 4 4 4 4 4 4 5
5 4 4 4 4 4 4 4 4 4 4 4 4 4 4 4 4 4 4 4 4 4 4 4 4 4 4 4 4 4 4 4 4 4 4 4 4 4 1 0 2 4 4 4 4 4 4 4 4 4 4 5
5 4 4 4 4 4 4 4 4 4 4 4 4 4 4 4 4 4 1 0 2 4 4 4 4 4 4 4 4 4 4 4 1 0 2 4 1 0 2 4 4 4 1 0 2 4 4 4 4 4 4 5
5 4 4 4 4 4 4 4 4 4 4 4 4 4 4 4 4 4 1 0 2 4 4 4 4 4 4 4 4 4 4 4 4 4 4 4 4 4 4 4 4 4 4 4 4 4 4 4 4 4 4 5
5 4 4 4 4 4 1 0 2 4 4 4 1 0 2 4 4 4 4 4 4 4 1 0 2 4 4 4 4 4 4 4 4 4 4 4 4 4 4 4 4 4 4 4 4 1 0 2 4 4 4 5
5 4 4 1 0 2 4 4 4 4 1 0 2 4 4 4 4 4 1 0 2 4 4 4 4 4 4 4 4 1 0 2 4 4 1 0 2 4 4 4 4 4 4 4 4 4 4 4 4 4 4 5
5 4 4 4 4 4 4 4 4 4 4 4 4 4 4 4 4 4 4 4 4 4 4 4 4 4 4 4 4 4 4 4 1 0 2 4 4 4 4 4 4 1 0 2 4 4 4 4 4 4 4 5
5 4 4 4 4 4 4 4 4 4 4 4 1 0 2 4 4 4 4 1 0 2 4 4 4 4 4 4 4 4 4 4 4 4 4 4 4 1 0 2 4 4 4 4 1 0 2 4 4 4 4 5
5 4 4 4 4 4 4 4 4 4 4 4 4 4 4 4 4 4 4 1 0 2 4 4 4 4 4 4 4 4 4 4 4 4 4 4 4 4 4 4 1 0 2 4 4 4 4 4 4 4 4 5
5 4 4 4 4 4 4 4 4 4 4 4 4 4 4 4 4 4 4 4 4 4 4 4 4 4 4 1 0 2 4 4 4 4 4 4 4 4 4 4 4 4 4 4 4 4 4 4 4 4 4 5
5 4 4 4 1 0 2 1 0 2 4 4 4 4 4 4 4 4 1 0 2 4 4 4 4 4 4 4 4 4 4 4 4 4 4 4 4 4 4 4 4 4 4 4 4 4 4 4 4 4 4 5
5 4 4 4 4 4 4 4 4 4 4 4 4 4 4 4 4 4 4 4 4 4 4 4 4 4 4 4 1 0 2 4 4 4 4 4 4 4 4 4 4 4 4 4 4 4 4 4 4 4 4 5
5 4 4 4 4 4 4 4 4 4 4 4 4 4 4 4 4 4 4 4 4 4 4 4 4 4 4 4 1 0 2 4 4 4 4 4 4 4 4 4 4 1 0 2 4 4 4 1 0 2 4 5
5 4 4 4 4 4 4 4 4 4 4 4 4 4 4 1 0 2 1 0 2 4 4 4 4 4 4 4 4 1 0 2 4 4 1 0 2 4 4 4 4 4 4 4 4 4 1 0 2 4 4 5
5 4 4 1 0 2 4 4 4 4 4 4 4 4 4 4 4 1 0 2 4 4 4 4 4 4 4 4 4 4 4 1 0 2 4 4 4 4 4 4 4 1 0 2 4 4 1 0 2 4 4 5
5 4 1 0 2 4 4 4 4 4 4 4 4 4 4 4 4 4 4 4 1 0 2 4 4 4 4 4 4 4 4 4 4 4 4 4 4 4 4 4 4 4 4 4 4 4 4 4 4 4 4 5
5 4 4 4 4 4 4 4 4 4 4 4 4 4 4 4 4 4 4 4 4 4 4 4 4 1 0 2 4 4 4 4 4 4 4 4 4 4 4 4 4 4 4 4 4 4 4 4 4 4 4 5
5 4 4 4 4 4 4 1 0 2 4 4 4 4 4 4 4 4 4 4 1 0 2 4 4 4 4 4 4 4 4 4 4 4 4 4 4 4 4 4 4 4 4 4 4 4 4 4 4 4 4 5
5 4 4 4 4 4 4 4 4 4 4 4 1 0 2 4 4 4 4 4 4 4 4 4 4 4 4 4 4 4 4 4 4 4 4 4 1 0 2 4 4 4 4 4 4 4 4 4 4 4 4 5
5 4 4 4 4 4 4 4 4 4 4 4 4 4 4 4 4 4 4 4 4 4 4 4 4 4 1 0 2 4 4 4 4 4 4 4 4 4 4 4 4 4 4 4 4 4 4 4 4 4 4 5
5 4 4 4 4 1 0 2 4 4 4 4 4 4 4 4 4 4 4 1 0 2 4 4 4 4 4 4 4 4 4 4 4 4 4 4 4 1 0 2 4 4 4 4 4 4 4 4 4 4 4 5
5 4 4 4 4 4 4 4 4 4 4 4 4 4 4 4 1 0 2 4 4 4 4 4 4 4 4 4 4 4 4 4 4 4 4 4 4 4 4 4 4 1 0 2 4 4 4 4 4 4 4 5
5 4 4 4 4 4 4 1 0 2 4 4 4 4 4 4 4 4 4 4 4 4 4 4 4 4 4 4 4 4 4 1 0 2 4 4 4 4 4 4 4 4 4 4 4 4 4 4 4 4 4 5
5 4 4 4 4 4 4 4 4 4 4 4 4 1 0 2 4 4 4 4 4 4 4 4 4 4 4 4 4 4 4 4 4 4 4 4 1 0 2 1 0 2 4 4 4 4 4 4 4 4 4 5
5 4 4 4 4 4 4 4 4 4 4 4 1 0 2 4 4 1 0 2 4 4 4 4 4 4 4 4 4 4 4 4 4 4 4 4 4 4 4 4 4 4 4 4 4 4 4 4 4 4 4 5
5 4 4 4 4 4 4 4 4 1 0 2 4 4 4 4 4 4 4 4 4 1 0 2 4 4 4 4 1 0 2 4 4 4 4 4 4 4 4 4 4 4 4 4 4 4 4 4 4 4 4 5
5 1 0 2 4 4 4 4 4 4 4 4 4 4 4 4 4 4 4 4 4 4 4 4 4 4 1 0 2 4 4 4 4 4 4 4 4 4 4 4 4 4 4 4 4 4 1 0 2 4 4 5
5 4 4 4 4 4 4 4 4 4 4 4 4 4 4 4 4 4 4 4 4 4 4 4 4 4 4 4 4 4 4 4 4 4 4 4 4 4 4 4 4 4 4 4 4 4 4 4 4 4 4 5
5 4 4 4 4 4 4 4 4 4 4 1 0 2 4 4 4 4 4 1 0 2 4 4 4 4 4 1 0 2 4 4 4 4 4 4 4 4 4 4 4 4 4 4 4 4 4 4 4 4 4 5
5 4 4 4 4 4 4 4 4 4 4 4 4 4 4 4 4 1 0 2 4 4 4 4 4 4 4 4 4 4 4 4 1 0 2 4 4 1 0 2 4 4 4 4 4 4 4 4 4 4 4 5
5 4 4 4 1 0 2 4 4 4 4 4 4 4 4 4 4 1 0 2 4 4 4 1 0 2 4 4 4 4 4 4 4 4 4 4 4 4 4 4 4 4 4 4 4 4 4 4 4 4 4 5
5 1 0 2 4 4 4 4 4 4 4 4 4 4 4 4 4 4 4 4 4 4 4 4 1 0 2 4 4 4 4 4 4 4 4 4 4 4 4 4 4 4 4 4 4 4 4 4 4 4 4 5
5 4 4 4 4 4 4 4 4 4 4 4 4 4 4 4 4 1 0 2 4 4 4 4 4 4 4 4 4 4 4 4 4 4 4 4 4 4 4 4 4 4 4 4 4 4 4 4 4 4 4 5
5 4 4 4 4 4 4 4 4 4 4 4 4 4 4 4 4 4 4 4 4 4 4 4 4 4 4 4 4 4 4 4 4 4 4 1 0 2 4 4 4 4 4 4 4 4 4 4 4 4 4 5
5 4 4 4 4 1 0 2 4 4 4 4 4 4 4 4 4 4 4 4 4 4 4 4 4 4 4 4 4 4 4 4 4 4 1 0 2 4 4 4 4 4 4 4 4 4 4 4 4 4 4 5
5 1 0 2 4 4 4 4 4 4 4 4 4 4 4 4 4 4 4 4 4 4 4 4 4 4 4 4 1 0 2 4 4 4 4 4 4 4 4 4 4 4 4 4 4 4 4 4 4 4 4 5
5 4 4 4 4 4 4 4 4 4 4 4 4 4 4 4 4 4 4 4 4 4 4 4 4 4 4 4 4 4 4 4 4 4 4 4 4 4 4 1 0 2 4 4 4 4 4 4 4 4 4 5
5 4 4 4 4 4 4 4 4 4 4 4 4 4 4 4 4 4 4 4 1 0 2 4 4 4 4 4 4 4 4 4 4 4 4 4 4 4 4 4 4 4 4 4 1 0 2 4 4 4 4 5
5 4 4 4 4 4 4 4 4 4 4 4 4 4 4 4 4 4 4 4 4 4 4 4 4 4 4 4 4 4 4 1 0 2 4 4 4 4 4 4 4 4 4 4 4 4 4 4 4 4 4 5
5 4 4 4 4 4 4 4 1 0 2 4 4 4 4 4 4 4 4 4 4 4 4 4 4 4 4 4 4 4 4 4 4 4 4 4 4 4 4 4 4 4 4 4 4 4 4 4 4 4 4 5
5 4 4 4 4 4 4 4 4 4 4 4 4 4 4 4 4 4 4 4 4 4 4 4 4 4 4 4 4 4 4 4 4 4 4 4 4 4 4 4 4 4 4 4 4 4 4 4 4 4 4 5
5 4 4 4 4 4 4 4 4 4 4 4 4 4 4 4 4 4 4 4 4 4 4 4 4 4 4 4 4 4 4 4 4 4 4 4 4 4 4 4 4 4 4 4 4 4 4 1 0 2 4 5
5 1 0 2 4 4 4 4 4 4 4 4 4 4 4 4 4 1 0 2 4 4 4 4 4 4 4 4 4 4 4 4 4 4 4 4 4 4 4 4 4 4 4 4 4 4 4 4 4 4 4 5
5 4 4 4 4 4 4 4 4 4 4 1 0 2 1 0 2 1 0 2 4 4 4 4 4 4 4 4 4 4 4 4 4 4 4 4 4 4 4 4 1 0 2 4 4 4 4 4 4 4 4 5
5 4 4 1 0 2 4 1 0 2 4 4 4 4 4 4 4 4 4 4 1 0 2 4 4 4 4 4 4 4 4 4 4 4 4 4 4 4 4 4 4 4 4 4 4 4 4 4 4 4 4 5
5 4 4 4 4 4 4 4 4 4 4 4 4 4 4 4 4 4 4 4 4 4 4 4 4 4 4 4 4 4 4 4 4 4 4 1 0 2 4 4 4 4 4 4 4 4 4 4 4 4 4 5
5 4 4 4 4 4 4 4 4 4 4 4 4 4 4 4 4 4 4 1 0 2 4 4 4 4 4 1 0 2 4 4 4 4 4 4 4 4 4 4 4 4 4 4 4 4 4 4 4 4 4 5
5 4 4 4 4 4 1 0 2 4 4 4 4 4 4 4 4 4 4 4 4 4 4 4 4 4 4 4 4 4 4 4 4 4 4 4 4 4 4 4 4 4 4 4 4 4 4 4 4 4 4 5
5 4 1 0 2 4 4 4 4 4 4 4 4 4 4 4 4 4 4 1 0 2 4 4 4 4 4 4 4 4 4 1 0 2 4 4 4 4 4 4 4 4 4 4 4 4 4 4 4 4 4 5
5 4 4 4 4 4 4 4 4 4 4 4 4 4 4 4 4 4 4 4 4 4 4 4 1 0 2 4 4 4 4 4 4 4 4 4 4 4 4 4 4 4 4 4 4 4 4 4 4 4 4 5
5 4 4 4 4 4 4 4 4 4 4 4 4 1 0 2 4 4 4 4 4 4 4 4 4 4 4 4 1 0 2 4 4 1 0 2 4 4 4 4 4 4 4 4 4 4 4 4 4 4 4 5
5 4 4 4 4 4 4 4 4 4 4 4 4 4 4 4 4 4 4 4 4 4 1 0 2 4 4 4 4 4 4 4 4 4 4 4 1 0 2 1 0 2 1 0 2 4 4 4 4 4 4 5
5 4 4 4 4 4 4 4 4 4 4 4 4 4 4 4 4 4 4 4 4 4 4 4 4 4 4 4 4 4 4 4 4 4 4 4 4 4 4 4 4 4 4 4 4 4 4 4 4 4 4 5
5 4 4 4 4 4 4 1 0 2 4 4 4 1 0 2 4 4 4 4 4 4 4 4 4 4 4 4 4 4 4 4 4 4 4 4 4 4 4 4 4 1 0 2 4 4 1 0 2 4 4 5
5 4 4 4 4 4 4 4 4 4 4 4 4 4 4 4 4 4 1 0 2 4 4 4 4 4 4 4 4 4 4 4 4 4 4 4 4 4 4 4 4 4 4 4 4 4 4 4 4 4 4 5
5 4 4 4 4 4 4 4 4 4 4 4 4 4 4 4 4 1 0 2 4 4 4 4 4 4 4 4 4 4 4 4 4 4 4 4 4 4 4 1 0 2 4 4 4 4 4 4 4 4 4 5
5 4 4 4 4 4 4 4 4 1 0 2 4 4 4 4 4 4 4 4 4 4 4 4 4 4 4 4 4 4 1 0 2 4 4 4 4 4 4 4 4 4 4 4 4 4 4 4 4 4 4 5
5 4 4 4 4 4 4 4 4 4 4 4 4 1 0 2 4 4 4 4 4 4 4 4 4 4 4 4 4 4 4 4 4 4 4 4 4 4 4 4 4 4 4 4 4 4 4 4 4 4 4 5
5 4 4 1 0 2 4 4 4 4 4 4 4 4 4 4 4 4 4 4 4 4 4 4 4 4 4 4 4 4 4 4 4 4 1 0 2 4 4 4 4 4 4 4 4 4 4 4 4 4 4 5
5 4 4 4 4 4 4 4 4 4 4 4 4 1 0 2 4 1 0 2 4 4 4 4 4 1 0 2 4 4 4 4 4 4 1 0 2 4 4 4 4 4 1 0 2 4 4 4 4 4 4 5
5 4 4 4 4 4 4 4 4 4 4 4 4 4 4 4 4 4 4 1 0 2 4 4 4 4 4 4 4 4 4 4 1 0 2 4 4 4 4 4 4 4 4 4 1 0 2 4 4 4 4 5
5 4 4 4 4 4 4 1 0 2 4 4 4 4 4 4 4 4 4 4 4 4 4 4 4 4 4 4 4 4 4 4 4 4 4 4 4 4 4 4 4 4 4 4 4 4 4 4 4 4 4 5
5 4 4 4 4 4 4 4 4 4 4 4 4 4 4 4 4 4 1 0 2 4 4 4 4 4 1 0 2 4 4 4 4 4 4 4 4 4 4 4 4 4 4 4 4 4 4 4 4 4 4 5
5 4 4 4 4 4 4 4 4 4 1 0 2 4 4 4 4 4 4 1 0 2 4 4 4 4 1 0 2 4 4 1 0 2 4 4 4 4 4 4 4 4 4 4 4 4 4 4 4 4 4 5
5 1 0 2 1 0 2 4 4 4 4 4 4 1 0 2 4 4 4 4 4 4 4 4 4 4 4 4 4 4 4 4 4 4 4 4 1 0 2 4 4 4 1 0 2 4 4 4 4 4 4 5
5 4 4 4 4 4 4 4 4 4 4 4 4 4 4 4 1 0 2 4 4 4 4 4 4 4 4 4 4 4 4 4 4 4 4 4 4 4 4 4 4 4 4 4 4 4 1 0 2 4 4 5
5 4 4 4 4 4 4 1 0 2 4 4 4 1 0 2 4 4 4 4 4 4 4 4 4 4 4 4 4 4 4 4 4 4 4 4 4 4 4 4 4 4 4 4 4 4 4 4 4 4 4 5
5 4 4 4 4 4 4 4 4 4 4 4 4 4 4 4 4 4 4 4 4 4 4 4 4 4 4 4 4 4 4 4 4 4 4 4 4 4 1 0 2 4 4 1 0 2 4 4 4 4 4 5
5 4 4 4 4 4 4 4 4 4 4 4 4 4 4 4 4 4 1 0 2 4 1 0 2 4 1 0 2 4 4 4 4 4 4 4 4 4 4 4 4 4 4 4 4 4 4 4 4 4 4 5
5 4 4 4 4 4 4 4 4 4 4 4 4 4 4 4 4 4 4 4 4 4 4 4 4 4 4 1 0 2 4 4 4 4 1 0 2 4 4 4 4 4 4 4 4 4 4 4 4 4 4 5
5 4 4 4 4 4 4 4 4 4 4 4 4 4 4 4 4 4 4 4 4 4 4 4 4 4 4 4 4 4 4 4 4 4 4 4 4 4 4 4 4 4 1 0 2 4 4 4 4 4 4 5
5 4 1 0 2 4 1 0 2 4 4 4 1 0 2 4 4 4 4 4 4 4 4 4 4 4 4 4 4 4 4 4 4 4 4 4 4 4 4 4 4 4 4 4 4 4 4 4 4 4 4 5
5 4 4 4 4 4 4 4 4 4 4 4 4 4 1 0 2 4 4 4 4 1 0 2 4 4 4 4 4 4 1 0 2 4 4 4 4 4 4 4 4 4 4 4 4 4 4 4 4 4 4 5
5 4 4 4 4 4 4 4 4 4 4 4 4 4 4 4 4 1 0 2 4 4 4 4 4 4 4 4 4 4 4 4 1 0 2 4 4 4 4 4 4 4 4 4 4 4 1 0 2 4 4 5
5 1 0 2 4 4 4 4 4 4 1 0 2 4 4 4 4 4 1 0 2 4 4 4 4 4 4 4 4 4 4 4 4 4 4 4 4 4 4 1 0 2 1 0 2 4 4 4 4 4 4 5
5 4 4 4 4 4 4 4 4 4 4 4 4 4 4 4 4 4 4 4 4 4 4 4 4 4 4 4 4 4 4 4 4 1 0 2 4 1 0 2 4 4 4 4 4 4 4 4 4 4 4 5
5 4 4 4 4 4 4 4 4 4 4 4 4 4 4 4 4 4 4 4 4 4 4 4 1 0 2 4 4 4 4 4 4 4 4 4 4 1 0 2 1 0 2 4 4 4 4 4 4 4 4 5
5 4 4 4 4 4 4 4 4 4 4 4 4 4 4 4 4 4 4 4 4 4 4 4 4 4 4 4 4 4 4 4 4 4 4 4 4 4 4 4 4 4 4 4 4 4 4 4 4 4 4 5
5 4 4 4 4 4 4 4 1 0 2 4 4 4 4 4 4 4 4 4 4 4 4 1 0 2 1 0 2 4 4 4 1 0 2 4 4 4 4 4 4 4 4 4 4 4 4 4 4 4 4 5
5 4 4 4 4 4 4 4 4 4 4 1 0 2 4 4 4 4 4 4 4 4 4 4 4 4 4 4 4 4 4 4 4 4 4 4 4 4 4 4 4 4 4 4 4 4 4 4 4 4 4 5
5 4 4 4 4 4 4 4 4 4 4 4 4 4 4 4 4 4 4 4 4 4 4 4 4 4 1 0 2 4 1 0 2 4 4 4 4 4 4 4 4 4 4 4 4 4 4 4 4 4 4 5
5 4 4 4 4 4 4 4 4 4 4 4 4 4 4 4 4 4 4 4 4 4 4 4 4 4 4 4 4 4 4 4 4 4 4 4 1 0 2 4 4 4 4 4 4 4 4 4 4 4 4 5
5 4 4 4 4 4 4 4 4 4 1 0 2 4 4 4 4 4 4 4 4 4 4 4 4 4 4 4 4 4 4 4 4 4 4 4 4 4 4 4 4 4 4 4 4 4 4 4 4 4 4 5
5 4 4 4 4 4 4 4 4 4 4 4 4 4 4 4 4 4 1 0 2 4 4 4 4 4 4 4 4 4 4 4 4 4 4 4 4 4 4 4 4 4 4 4 4 4 4 4 4 4 4 5
5 4 4 4 1 0 2 4 1 0 2 4 4 4 4 1 0 2 4 4 4 1 0 2 4 4 4 4 4 4 4 1 0 2 4 4 4 4 4 4 4 4 4 4 4 4 4 4 4 4 4 5
5 4 4 4 4 4 4 4 4 4 4 4 4 4 4 4 4 4 4 4 4 4 4 4 4 4 4 4 4 4 4 4 4 4 4 4 4 4 4 4 4 4 4 4 4 1 0 2 4 4 4 5
5 4 4 4 4 4 4 4 4 4 4 4 4 4 4 4 4 4 4 4 4 4 4 4 4 4 4 4 4 1 0 2 4 4 4 4 4 4 4 4 4 4 4 4 4 4 4 4 4 4 4 5
5 1 0 2 4 4 4 4 4 4 4 4 4 4 4 4 1 0 2 1 0 2 4 4 4 4 4 4 4 4 4 4 4 4 4 4 1 0 2 4 4 4 4 4 4 4 4 4 4 4 4 5
5 4 4 4 4 4 4 4 4 4 4 4 4 4 4 4 4 4 4 4 4 4 4 4 4 4 4 4 4 4 4 4 4 4 4 4 4 4 4 4 4 4 4 4 4 4 4 4 4 4 4 5
5 4 4 4 4 4 4 4 4 4 4 4 4 4 4 4 1 0 2 4 4 4 1 0 2 4 4 4 4 4 4 4 4 4 4 4 4 4 4 4 4 4 4 4 4 4 4 1 0 2 4 5
5 4 4 4 4 4 4 4 4 4 4 4 4 4 4 4 4 4 4 4 4 4 4 4 4 4 4 4 4 1 0 2 4 4 4 4 1 0 2 4 4 4 4 4 4 4 4 4 4 4 4 5
5 4 4 4 4 4 4 4 4 4 4 4 4 4 4 4 4 4 4 4 4 4 4 4 4 4 4 4 4 4 4 4 4 4 4 4 4 1 0 2 4 4 4 1 0 2 4 4 4 4 4 5
5 1 0 2 4 4 4 4 4 1 0 2 4 4 4 4 4 4 4 4 4 4 1 0 2 4 4 4 4 4 4 4 4 4 4 4 4 4 4 1 0 2 4 4 4 4 4 4 4 4 4 5
5 4 4 4 4 4 4 4 4 4 4 4 4 4 4 4 1 0 2 4 4 4 4 4 4 4 4 4 4 4 4 4 4 4 4 4 4 4 4 4 4 4 4 4 4 4 4 4 4 4 4 5
5 5 5 5 5 5 5 5 5 5 5 5 5 5 5 5 5 5 5 5 5 5 5 5 5 5 5 5 5 5 5 5 5 5 5 5 5 5 5 5 5 5 5 5 5 5 5 5 5 5 5 5
